initialRequiredInformation=Initial Required Information
who=Who
submitter=Submitter
reporter=Reporter
reporterType=Reporter Type
what=What
incidentCategory=Incident Category
selectCategory=--- Select a Category ---
incidentSubcategory=Incident Subcategory
selectSubcategory=--- Select a Subcategory ---
incidentType=Incident Type
selectType=--- Select a Type ---
whenWhere=When & Where
dateTime=Date and Time of Occurrence
impactedRegions=Impacted Region(s)
impactedCountry=Impacted Country
selectCountries=--- Select Countries ---
facilitiesAffected=Facilities Affected
facilityDirections=Enter the IDs of the affected facilities separated by a comma.
impact=Impact
impactPersonnel=Impact to Personnel
selectImpact=--- Select the Impact ---
impactTravelers=Impact to Travelers
impactFacilities=Impact to Facilities
impactOperations=Impact to Operations
documentIncident=Document New Incident
buttonSubmitAnother=Submit & Create Another
buttonSubmit=Submit
buttonCancel=Cancel
incidentTitleInstructions=Create a succinct name for the incident.
incidentTitle=Incident Title
basicInformation=Basic Information